###########################
###                     ###
### #########S     #### ###
### ############## ### K ##
### #########T     #### ###
###   H       #########  ##
##   ##              ### ##
## #################  E  ##
##  I ################ ####
#### ################# ####
####                   ####
###########################
